{
  "name": "Level5",
  "nextLevel": "level6",
  "background": "map1",
  "theme": 0,
  "layout": [
    "############",
    "#p...#....D#",
    "#..#..  ..##",
    "##....gg...#",
    "#..  .#....#",
    "#..gg..  ..#",
    "#..#...gg..#",
    "#......#..##",
    "#..........#",
    "##  .#.   .#",
    "#.gg... B .#",
    "#D.....#ggF#",
    "############"
  ]
}
