{
    "name": "Level16",
    "nextLevel": "level17",
    "background": "map4",
    "theme":4,
    "layout": [
      "##########################",
      "#po                      #",
      "#$$$$$              f    #",
      "# ##$$$$$         #;;;#  #",
      "#d #####$$         ###   #",
      "###  ####$$         $    #",
      "##;;;#####$$        $    #",
      "###;##oo.##$$;;;;;;;$;;;;#",
      "######.o.o.#########$#####",
      "#...d.o.............$#####",
      "#d..###[            $#####",
      "#######....###############",
      "##########################"
    ]
  }
  