{
  "name": "Level1",
  "nextLevel": "level2",
  "layout": [
    "##########################",
    "#pO ......O ......O .....#",
    "#.....OOOO...............#",
    "#........................#",
    "#......O.................#",
    "#.....OOO................#",
    "#################.... ...#",
    "#....................l...#",
    "#......O..........lll ...#",
    "#.....OOO................#",
    "#............. L ........#",
    "#.....DDDD...............#",
    "#..........OOO........f..#",
    "##########################"
  ]
}
