{
  "name": "Level6",
  "nextLevel": "level7",
  "background": "map2",
  "theme": 1,
  "layout": [
    "###################",
    "#..O..#.O...O.....#",
    "#..p .#..O. ....D.#",
    "#.OggO#...  .O....#",
    "#.....#.D.ggO.. O.#",
    "#O.O..#.O.....Og..#",
    "#....O#...O.#######",
    "#......  .........#",
    "#                .#",
    "#od  o       o  f #",
    "#ggggggggggDgggggg#",
    "#..O...O.....OO...#",
    "###################"
  ]
}
