{
  "name": "Level8",
  "nextLevel": "level9",
  "background": "map2",
  "theme": 1,
  "layout": [
    "#######################",
    "#DO...O.#.O..O..D.....#",
    "#.E. ...#D........ .O.#",
    "#... ..O#.        w ..#",
    "#.O. .O.#.gggggggg g..#",
    "#... ...#######... .E.#",
    "#... ..D.O....O... ...#",
    "#.O. ..O...p...... .O.#",
    "#... ......FO...O. .D.#",
    "#O.. .O.#######... ..O#",
    "#... .........#.O. .O.#",
    "#.. W        D#... ...#",
    "#D.g gggggggg.#O.. .O.#",
    "#.O.g....O....#D..g...#",
    "#######################"
  ]
}
