{
  "name": "Level1",
  "nextLevel": "level2",
  "layout": [
    "##########################",
    "#pO ......O ......E .....#",
    "#.....OOOO.........   ...#",
    "#.................. L ...#",
    "#......O....   ....   ...#",
    "#.D...OOO... s ..........#",
    "#################........#",
    "#..........  .  ....   ..#",
    "#    ..O...     .... l ..#",
    "#    .OOO...   .....   ..#",
    "#  B ...... w   .........#",
    "#    .DDDD.  .    .......#",
    "#..........OOO........F..#",
    "##########################"
  ]
}
