{
    "name": "Level12",
    "nextLevel": "level13",
    "background": "map3",
    "theme":3,
    "layout": [
      "###################",
      "#   d#     #oo #dd#",
      "#   #####  #o  #  #",
      "#     o   d$$     #",
      "#  #####  #  ##   #",
      "#    pf#;;##;;;;;;#",
      "###################"
    ]
  }
  