{
    "name": "Level3",
    "nextLevel": "level1",
    "layout": [
      "####################################################################################################",
      "#pO .....##.O .....##.O .....##.O .....##.O .....##.O .....##.O .....##.O .....##.O .....##.O .....#",
      "#........##........##........##........##........##........##........##........##........##........#",
      "#..OOO.D.##..OOO.D.##..OOO.D.##..OOO.D.##..OOO.D.##..OOO.D.##..OOO.D.##..OOO.D.##..OOO.D.##..OOO.D.#",
      "#.D......##.D......##.D......##.D......##.D......##.D......##.D......##.D......##.D......##.D......#",
      "#.....D..##.....D..##.....D..##.....D..##.....D..##.....D..##.....D..##.....D..##.....D..##.....D..#",
      "#........##........##........##........##........##........##........##........##........##........#",
      "#.....D..##.....D..##.....D..dd.....D..##.....D..##.....D..##.....D..##.....D..##.....D..##.....D..#",
      "#........##........##........##........##........##........##........##........dd........##........#",
      "#.....D..dd.....D..##.....D..##.....D..##.....D..##.....D..##.....D..##.....D..##.....D..##.....D..#",
      "#........##........##........##........##........##........##........dd........##........##........#",
      "#.....D..##.....D..dd.....D..##.....D..##.....D..##.....D..##.....D..##.....D..##.....D..##.....D..#",
      "#........##........##........##........dd........##........dd........##........##........##........#",
      "#.....D..##.....D..##.....D..##.....D..##.....D..##.....D..##.....D..##.....D..##.....D..##.....D..#",
      "#........##........##........##........##........##........##........##........##........dd........#",
      "#.....D..##.....D..##.....D..##.....D..##.....D..dd.....D..##.....D..##.....D..##.....D..##.....D..#",
      "#........##........##........##........##........##........##........##........##........##........#",
      "#.....D..##.....D..##.....D..##.....D..##.....D..##.....D..##.....D..##.....D..##.....D..##.....D..#",
      "#........##........##........##........##........##........##........##........##........##........#",
      "#.....D..dd.....D..##.....D..##.....D..##.....D..##.....D..##.....D..##.....D..##.....D..##.....D..#",
      "#........##........##........##........##........##........##........dd........##........##........#",
      "#.....D..##.....D..dd.....D..##.....D..##.....D..##.....D..##.....D..##.....D..##.....D..##.....D..#",
      "#........##........##........##........dd........##........dd........##........##........##........#",
      "#.....D..##.....D..##.....D..##.....D..##.....D..##.....D..##.....D..##.....D..##.....D..##.....D..#",
      "#........##........##........##........##........##........##........##........##........dd........#",
      "#.....D..##.....D..##.....D..##.....D..##.....D..dd.....D..##.....D..##.....D..##.....D..##.....D..#",
      "#........##........##........##........##........##........##........##........##........##........#",
      "#.....D..##.....D..##.....D..##.....D..##.....D..##.....D..##.....D..##.....D..##.....D..##.....D..#",
      "#........##........##........##........##........##........##........##........##........##........#",
      "#.....D..dd.....D..##.....D..##.....D..##.....D..##.....D..##.....D..##.....D..##.....D..##.....D..#",
      "#........##........##........##........##........##........##........dd........##........##........#",
      "#.....D..##.....D..dd.....D..##.....D..##.....D..##.....D..##.....D..##.....D..##.....D..##.....D..#",
      "#........##........##........##........dd........##........dd........##........##........##........#",
      "#.....D..##.....D..##.....D..##.....D..##.....D..##.....D..##.....D..##.....D..##.....D..##.....D..#",
      "#........##........##........##........##........##........##........##........##........dd........#",
      "#.....D..##.....D..##.....D..##.....D..##.....D..dd.....D..##.....D..##.....D..##.....D..##.....D..#",
      "#........##........##........##........##........##........##........##........##........##........#",
      "#.....D..##.....D..##.....D..##.....D..##.....D..##.....D..##.....D..##.....D..##.....D..##.....D..#",
      "#........##........##........##........##........##........##........##........##........##........#",
      "#OOO.....##OOO.....##OOO.....##OOO.....##OOO.....##OOO.....##OOO.....##OOO.....##OOO.....##OOO.....#",
      "#OOO.....##OOO.....##OOO.....##OOO.....##OOO.....##OOO.....##OOO.....##OOO.....##OOO.....##.......f#",
      "####################################################################################################"
    ]
  }
  