{
  "name": "Level10",
  "nextLevel": "level11",
  "background": "map2",
  "theme": 1,
  "layout": [
    "####################",
    "#.................F#",
    "#..p........  .....#",
    "#........... B.....#",
    "#..................#",
    "#....SSSSSSSSSS....#",
    "#....SSSSSSSSSS....#",
    "#....SSSSSSSSSS....#",
    "#....SSSSSSSSSS....#",
    "#....SSSSSSSSSS....#",
    "#....SSSSSSSSSS....#",
    "#....SSSSSSSSSS....#",
    "#....SSSSSSSSSS....#",
    "#....SSSSSSSSSS....#",
    "#....SSSSSSSSSS....#",
    "#..................#",
    "#..................#",
    "#..................#",
    "#..................#",
    "####################"
  ]
}
