{
    "name": "Level17",
    "nextLevel": "level18",
    "background": "map4",
    "theme":4,
    "layout": [
      "##################################################",
      "#                                                #",
      "#                                                #",
      "#                                                #",
      "#                                                #",
      "#                                                #",
      "#  p                                             #",
      "#gggggggggggggggggggggggggggggggggggggggggggggggg#",
      "#............................................f...#",
      "#................................................#",
      "#................................................#",
      "#................................................#",
      "##################################################"
    ]
  }
  