{
    "name": "Level17",
    "nextLevel": "level18",
    "background": "map4",
    "theme":4,
    "layout": [
      "##################################################",
      "#                       #                        #",
      "#  B              #    ###        #          B   #",
      "#            #   ###  #####      ###             #",
      "#           ###   #    ###      #####            #",
      "#           ###   #     #       #####            #",
      "#  p      d  #  d #  d  #  d      #          f   #",
      "#............#....#.....#.........#..............#",
      "#............#..........#.........#..............#",
      "#.......................#.........#..............#",
      "#.................................#..............#",
      "#;;;;;;;;;;;;;;;;;;;;;;;;;;;;;;;;;;;;;;;;;;;;;;;;#",
      "##################################################"
    ]
  }
  