{
    "name": "Level12",
    "nextLevel": "level13",
    "background": "map3",
    "theme":3,
    "layout": [
      "###################",
      "#   d#     #E  #dd#",
      "#   #####  #E  #  #",
      "#     o   d$$     #",
      "#  #####  #  ##   #",
      "#    pf#;;##;;;;;;#",
      "###################"
    ]
  }
  