{
    "name": "Level20",
    "nextLevel": "level1",
    "background": "map4",
    "theme":3,
    "layout": [
      "##################################",
      "#     :       # #dE              #",
      "#    ##       #f $##     dE      #",
      "#  Ed       o    $#     ####     #",
      "# $$$$     $#     $$o    ##      #",
      "#$  $              $#           E#",
      "#                            d EE#",
      "#   ##    o        #       $$$$$$#",
      "#         ##:p     #        $$ d #",
      "#          ##$$$$$$#         $$$$#",
      "#          $  d   $#            s#",
      "#;;;;;;;;;;;;;;;;;;;;;;;;;;;;;;;;#",
      "##################################"
    ]
  }
  