{
    "name": "Level11",
    "nextLevel": "level12",
    "background": "map3",
    "theme":3,
    "layout": [
      "##########################",
      "#oooooooooooooooooo   d  #",
      "#d                       #",
      "#d                       #",
      "### $$$$$$$$$$$$$$       #",
      "###                      #",
      "####$$$$$$$$$$$$$$    pf #",
      "#### $ $ $ $ $ $ #########",
      "#;;;;;;;;;;;;;;;;;;;;;;;;#",
      "#;;;;;;;;;;;;;;;;;;;;;;;;#",
      "#;;;;;;;;;;;;;;;;;;;;;;;;#",
      "##;;;;;;;;;;;;;;;;;;;;;;##",
      "##########################"
    ]
  }
  