{
  "name": "Level1",
  "nextLevel": "level2",
  "background": "map1",
  "theme":0,
  "layout": [
    "##########################",
    "#                        #",
    "#                  :     #",
    "#                 :::    #",
    "#                 :::    #",
    "#                  $     #",
    "#  p               $     #",
    "#gggggggggggggggggggggggg#",
    "#....................f...#",
    "#.............D..........#",
    "#........................#",
    "#........................#",
    "##########################"
  ]
}
