{
    "name": "Level20",
    "nextLevel": "level1",
    "background": "map4",
    "theme":3,
    "layout": [
      "##################################",
      "#     :       # #d               #",
      "#    ##       #f $#      d       #",
      "#  d        o    $#     ####     #",
      "#  $$$     $#     $$o    ##      #",
      "#   $              $#            #",
      "#                            d   #",
      "#   ##    o                $$$$$$#",
      "#         ##:p              $$ d #",
      "#          ##$$$$$$          $$$$#",
      "#          $  d   $             s#",
      "#;;;;;;;;;;;;;;;;;;;;;;;;;;;;;;;;#",
      "##################################"
    ]
  }
  