{
  "name": "Level2",
  "nextLevel": "level3",
  "background": "map2",
  "theme":0,
  "layout": [
    "#############################",
    "#O                          #",
    "#OD                         #",
    "#OOD                        #",
    "#OOOD              p        #",
    "#OOOOD             :        #",
    "#OOOOOD           :::       #",
    "#OOOOOOD          :::       #",
    "#OOOOOOOD          $        #",
    "#OOOOOOOOD         $        #",
    "#.........gggggggggggggggggg#",
    "#....................f......#",
    "#.............D.............#",
    "#...........................#",
    "#...........................#",
    "#############################"
  ]
}
