{
  "name": "Level6",
  "nextLevel": "level7",
  "background": "map2",
  "theme": 1,
  "layout": [
    "###################",
    "#..O..#.O...O.....#",
    "#..p .#..O. ....D.#",
    "#.OggO#...  .O....#",
    "#.....#.D.ggO.. O.#",
    "#O.O..#.O.....Og..#",
    "#....O#...O.#######",
    "#..O...  .....O...#",
    "#                .#",
    "#od             f #",
    "#ggggggggggdgggggg#",
    "#..O...O.....OO...#",
    "###################"
  ]
}
