{
    "name": "Level15",
    "nextLevel": "level16",
    "background": "map3",
    "theme":2,
    "layout": [
      "#################################",
      "#d       o ####     ##  ###  w###",
      "######## # #### ##    # ### # ###",
      "#p       #       ####    #  #  d#",
      "#### ## #### ## ## # ## #####d###",
      "# ## ## #### ## ##   ##       ###",
      "#    ##  #         # ## #########",
      "# ##   ### #### ## # ##d      d##",
      "# ## ##### ### ##### ##### ### ##",
      "#        d      ####### #### ####",
      "####### ### ##        ### #### ##",
      "##d     #   ## ########## #### ##",
      "####d###### ##     ####d     # ##",
      "## w     ## ## ###d#### #### # ##",
      "## #####  #### ### #### ####d####",
      "## d##    ###             ## w f#",
      "## ### # ######### ## ### #######",
      "#################################"
    ]
  }
  