{
    "name": "Level16",
    "nextLevel": "level17",
    "background": "map4",
    "theme":4,
    "layout": [
      "##########################",
      "# p o                    #",
      "#$$$$$              f    #",
      "# ##$$$$$         #;;;#  #",
      "#d #####$$         ###   #",
      "##   ####$$         $    #",
      "##;;;#####$$        $    #",
      "###;##oo.##$$;;;;;;;$;;;;#",
      "######.o.o.#########$#####",
      "#...d.o.............$#####",
      "#d..###.............$#####",
      "#######....###############",
      "##########################"
    ]
  }
  