{
  "name": "Level2",
  "nextLevel": "level3",
  "background": "map2",
  "layout": [
    "##########",
    "#pO .....#",
    "#........#",
    "#..OOO.D.#",
    "#.D......#",
    "#.....D..#",
    "#........#",
    "#OOO.....#",
    "#.......F#",
    "##########"
  ]
}
