{
  "name": "Level1",
  "nextLevel": "level2",
  "layout": [
    "##########################",
    "#pO ......O ......O .....#",
    "#.....OOOO.........   ...#",
    "#.................. L ...#",
    "#......O...........   ...#",
    "#.....OOO................#",
    "#################........#",
    "#..........  .  ....   ..#",
    "#......O...     .... l ..#",
    "#.....OOO...   .....   ..#",
    "#.......... w   .........#",
    "#.....DDDD.  .    .......#",
    "#..........OOO........f..#",
    "##########################"
  ]
}
