{
  "name": "Level3",
  "nextLevel": "level4",
  "background": "map1",
  "theme": 0,
  "layout": [
    "##########################",
    "#.D.  ....#......        #",
    "#O..gg..O.#.O...   :   f #",
    "#...O#....#....#  :::    #",
    "#....#...O#    #  :::    #",
    "#.O..#.O..#    #   $  :  #",
    "#....#....# L  #   $  $  #",
    "#..O.#O...#    #ggggggggg#",
    "#O...#...O#    #...O.....#",
    "#.  .#....#    #.O....O..#",
    "#.p .#.D...gggg#....O.D..#",
    "#.gg.#.......O.#.O.....O.#",
    "##########################"
  ]
}
