{
  "name": "Level10",
  "nextLevel": "level11",
  "background": "map2",
  "theme": 1,
  "layout": [
    "##########################",
    "#                        #",
    "#                  l     #",
    "#                 lll    #",
    "#                 lll    #",
    "#                  $     #",
    "#  p               $     #",
    "#gggggggggggggggggggggggg#",
    "#....................f...#",
    "#........................#",
    "#........................#",
    "#........................#",
    "##########################"
  ]
}
