{
  "name": "Level7",
  "nextLevel": "level8",
  "background": "map2",
  "theme": 1,
  "layout": [
    "###################",
    "#.O..O#...O.#O...O#",
    "#..D..#..D..#..D..#",
    "#.....#O.O..#.OO..#",
    "#...O.#.....#.....#",
    "#.O...#.. .O#....O#",
    "#....O... ...OO...#",
    "#.......   .....O.#",
    "#.O      w      ..#",
    "#..gggggg gggggg..#",
    "#........ ...O..O.#",
    "#######.. ..#######",
    "#..OO..O....O....O#",
    "#O........O....OO.#",
    "#.D...O..p..O...D.#",
    "#.O......F.O......#",
    "#...O...O.....O...#",
    "###################"
  ]
}
