{
  "name": "Level8",
  "nextLevel": "level9",
  "background": "map2",
  "theme": 1,
  "layout": [
    "##########################",
    "#pO ......O ...O..E ...D.#",
    "#..g..OOO..g....O..  ...O#",
    "#..O.........O..... l....#",
    "#......O...... O..   ..O.#",
    "#OD...OOO..O..g...    ...#",
    "#################  L     #",
    "#....E.....  .  .gggggggg#",
    "#..O.. O...     D..OOO...#",
    "#.d ..OOO..g   g.O.....D.#",
    "#Ogg....... w   .... O...#",
    "#...O.OO...  g  ...Og...O#",
    "#.O...O....ooOgg.......F.#",
    "##########################"
  ]
}
