{
  "name": "Level7",
  "nextLevel": "level8",
  "background": "map2",
  "theme": 1,
  "layout": [
    "###################",
    "#.O..O# ..O.#O...O#",
    "#..D..#g.D..#..D..#",
    "#.....#O.O..#.OO .#",
    "#...O.#.....#...g.#",
    "#.O ..#.. .O#....O#",
    "#..g.O... ...OO...#",
    "#.......   .....O.#",
    "#.O      w      ..#",
    "#..gggggg gggggg..#",
    "#........ ...O..O.#",
    "#######.. ..#######",
    "#..OO. O....O ...O#",
    "#O....g...O..g.OO.#",
    "#.D.. O..p..O...D.#",
    "#.O..g...F.O......#",
    "#...O ..O.... O...#",
    "###################"
  ]
}
