{
  "name": "Level2",
  "nextLevel": "level3",
  "background": "map1",
  "theme": 0,
  "layout": [
    "############",
    "#........ .#",
    "# p...O....#",
    "#########..#",
    "#.D....O...#",
    "#..........#",
    "#..#########",
    "#.... o    #",
    "########## #",
    "#.....     #",
    "#O..      o#",
    "#.       oo#",
    "#       gg##",
    "#        ..#",
    "#g    :    #",
    "#.   :::   #",
    "#    :::   #",
    "#     $    #",
    "# :   $::  #",
    "#:::  $::: #",
    "#:::  $::  #",
    "# $  :$    #",
    "# $o  $   o#",
    "#gggggggggg#",
    "#....O.....#",
    "#.F......O.#",
    "#.......D..#",
    "#...O......#",
    "############"
  ]
}
