{
    "name": "Level13",
    "nextLevel": "level14",
    "background": "map3",
    "theme":3,
    "layout": [
      "#############################",
      "#p                          #",
      "#ggggggggggggggggggggggggggg#",
      "#... OOD   ####..OOOOD..    #",
      "#..  ....      ###O..       #",
      "#.                ...       #",
      "#           o     ...       #",
      "#gg####ggggggggggg...ggggggg#",
      "#.O.O...........O.......F...#",
      "#O.D.O.O........O...........#",
      "#.....D.........O...........#",
      "#;;;;;;;;;;;;;;;;;;;;;;;;;;;#",
      "#############################"
    ]
  }
  