{
  "name": "Level1",
  "nextLevel": "level2",
  "layout": [
    "##########################",
    "#pO ......O ......O .....#",
    "#.....OOOO...............#",
    "#........................#",
    "#......O.................#",
    "#.....OOO................#",
    "#################........#",
    "#..........  .  .........#",
    "#......O...     .........#",
    "#.....OOO...   ..........#",
    "#..........     .........#",
    "#.....DDDD.W .    .......#",
    "#..........OOO........f..#",
    "##########################"
  ]
}
