{
    "name": "Level3",
    "nextLevel": "level4",
    "background": "map3",
    "theme":0,
    "layout": [
      "#############################",
      "#                           #",
      "#                           #",
      "#                           #",
      "#                  p        #",
      "#                           #",
      "#                           #",
      "#                           #",
      "#                           #",
      "#                           #",
      "#                           #",
      "#....................f......#",
      "#.............D.............#",
      "#...........................#",
      "#...........................#",
      "#############################"
    ]
  }
  