{
  "name": "Level1",
  "nextLevel": "level2",
  "layout": [
    "##########################",
    "#pO ......O ......O .....#",
    "#.....OOOO.........   ...#",
    "#.................. L ...#",
    "#......O....   ....   ...#",
    "#.....OOO... s ..........#",
    "#################........#",
    "#..........  .  ....   ..#",
    "#    ..O...     .... l ..#",
    "# A  .OOO...   .....   ..#",
    "#    ...... w   .........#",
    "#    .DDDD.  .    .......#",
    "#..........OOO........f..#",
    "##########################"
  ]
}
