{
  "name": "Level3",
  "nextLevel": "level4",
  "background": "map1",
  "theme": 0,
  "layout": [
    "##########################",
    "#.D.  ....#....O.      ..#",
    "#O..gg..O.#.O...   :     #",
    "#...O#....#....#  :::    #",
    "#....#...O#    #  :::    #",
    "#.O..#.O..#    #   $  :  #",
    "#....#....# L  #o  $  $d #",
    "#..O.#O...#    #ggggggggg#",
    "#O...#...O#    #...O.....#",
    "#.  .#....#    #..O...O..#",
    "#.p .#.D...gggg#.F..O....#",
    "#.gg.#.......O.#.O.....O.#",
    "##########################"
  ]
}
