{
  "name": "Level1",
  "nextLevel": "level2",
  "layout": [
    "##########################",
    "#pO ......O ......O .....#",
    "#.....OOOO...............#",
    "#............... L ......#",
    "#......O.................#",
    "#.....OOO................#",
    "#################........#",
    "#........................#",
    "#......O.................#",
    "#.....OOO................#",
    "#........................#",
    "#.....DDDD...............#",
    "#..........OOO........f..#",
    "##########################"
  ]
}
