{
    "name": "Level18",
    "nextLevel": "level19",
    "background": "map1",
    "theme":4,
    "layout": [
      "##########################",
      "#.   ...w  d.............#",
      "#. . ..........w   d.....#",
      "#.w.     d..... .........#",
      "#.......   w...       d..#",
      "#........................#",
      "#.p........   w  d...$...#",
      "#.... ..............$ $..#",
      "#d   ...w..........$dfd$.#",
      "#.......      ......$d$..#",
      "#....w...............$...#",
      "#....   ......w     d....#",
      "##########################"
    ]
  }
  